abacus: a manual computing device consisting of a frame holding parallel rods strung with movable counters
abate: to become less intense or widespread
aberrant: departing from an accepted standard or norm
abide: to accept or act in accordance with
abjure: to solemnly renounce (a belief, cause, or claim)
abrogate: to repeal or do away with (a law, right, or formal agreement)
abscond: to leave hurriedly and secretly, typically to avoid detection or arrest
abstruse: difficult to understand; obscure
accede: to agree to a demand, request, or treaty
acerbic: sharp and forthright
acumen: the ability to make good judgments and quick decisions, typically in a particular domain
adamant: refusing to be persuaded or to change one's mind
adroit: clever or skillful in using the hands or mind
adumbrate: to report or represent in outline
adventitious: happening or carried on according to chance rather than design or inherent nature
aegis: the protection, backing, or support of a particular person or organization
aesthetic: concerned with beauty or the appreciation of beauty
affable: friendly, good-natured, or easy to talk to
affinity: a spontaneous or natural liking or sympathy for someone or something
alacrity: brisk and cheerful readiness
albeit: although
alchemy: a seemingly magical process of transformation, creation, or combination
alias: a false or assumed identity
allegory: a story, poem, or picture that can be interpreted to reveal a hidden meaning, typically a moral or political one
alleviate: to make (suffering, deficiency, or a problem) less severe
altruism: the belief in or practice of disinterested and selfless concern for the well-being of others
amalgamate: to combine or unite to form one organization or structure
ameliorate: to make (something bad or unsatisfactory) better
amiable: having or displaying a friendly and pleasant manner
amorphous: without a clearly defined shape or form
anachronistic: belonging to a period other than that being portrayed
anathema: something or someone that one vehemently dislikes
annex: to append or add as an extra or subordinate part
anomaly: something that deviates from what is standard, normal, or expected
antebellum: occurring or existing before a particular war, especially the American Civil War
antediluvian: of or belonging to the time before the biblical Flood
anthropomorphic: relating to or characterized by anthropomorphism (the attribution of human characteristics or behavior to a god, animal, or object)
apocryphal: of doubtful authenticity, although widely circulated as being true
apogee: the highest point in the development of something; the climax or culmination
apostate: a person who renounces a religious or political belief or principle
apparatus: the technical equipment or machinery needed for a particular activity or purpose
apposite: apt in the circumstances or in relation to something
approbation: approval or praise
arcane: understood by few; mysterious or secret
arbitrary: based on random choice or personal whim, rather than any reason or system
archetype: a very typical example of a certain person or thing
arduous: involving or requiring strenuous effort; difficult and tiring
articulate: having or showing the ability to speak fluently and coherently
ascertain: to find (something) out for certain; make sure of
ascetic: characterized by or suggesting the practice of severe self-discipline and abstention from all forms of indulgence
asperity: harshness of tone or manner
assiduous: showing great care and perseverance
assuage: to make (an unpleasant feeling) less intense
astute: having or showing an ability to accurately assess situations or people and turn this to one's advantage
audacious: showing a willingness to take surprisingly bold risks
augment: to make (something) greater by adding to it; increase
auspicious: conducive to success; favorable
austere: severe or strict in manner, attitude, or appearance
avarice: extreme greed for wealth or material gain
avuncular: relating to an uncle
axiom: a statement or proposition that is regarded as being established, accepted, or self-evidently true
balk: to hesitate or be unwilling to accept an idea or undertaking
banal: so lacking in originality as to be obvious and boring
bane: a cause of great distress or annoyance
barrage: a concentrated artillery bombardment over a wide area
bastion: an institution, place, or person strongly defending or upholding particular principles, attitudes, or activities
behest: a person's orders or command
belligerent: hostile and aggressive
benevolent: well-meaning and kindly
berate: to scold or criticize (someone) angrily
bereft: deprived of or lacking something, especially a nonmaterial asset
beseech: to ask (someone) urgently and fervently to do something; implore; entreat
biased: unfairly prejudiced for or against someone or something
blandishment: a flattering or pleasing statement or action used to persuade someone gently to do something
blasphemy: the act or offense of speaking sacrilegiously about God or sacred things; profane talk
blithe: showing a casual and cheerful indifference considered to be callous or improper
bolster: to support or strengthen; prop up
bombastic: high-sounding but with little meaning; inflated
boon: a thing that is helpful or beneficial
boorish: rough and bad-mannered; coarse
bucolic: relating to the pleasant aspects of the countryside and country life
burgeon: to begin to grow or increase rapidly; flourish
buttress: a projecting support of stone or brick built against a wall
cacophony: a harsh, discordant mixture of sounds
cajole: to persuade someone to do something by sustained coaxing or flattery
calamity: an event causing great and often sudden damage or distress; a disaster
callous: showing or having an insensitive and cruel disregard for others
calumny: the making of false and defamatory statements about someone in order to damage their reputation; slander
camaraderie: mutual trust and friendship among people who spend a lot of time together
cameo: a small character part in a play or movie, played by a distinguished actor or a celebrity
canard: an unfounded rumor or story
candor: the quality of being open and honest in expression; frankness
capacious: having a lot of space inside; roomy
capitulate: to cease to resist an opponent or an unwelcome demand; surrender
capricious: given to sudden and unaccountable changes of mood or behavior
caricature: a picture, description, or imitation of a person in which certain striking characteristics are exaggerated in order to create a comic or grotesque effect
carnal: relating to physical, especially sexual, needs and activities
carouse: to drink plentiful amounts of alcohol and enjoy oneself with others in a noisy, lively way
carping: difficult to please; critical
catalyst: a substance that increases the rate of a chemical reaction without itself undergoing any permanent chemical change
categorical: unambiguously explicit and direct
catharsis: the process of releasing, and thereby providing relief from, strong or repressed emotions
caucus: a meeting of members of a political party to select candidates or decide policy
causal: relating to or acting as a cause
cavalier: showing a lack of proper concern; offhand
censure: express severe disapproval of (someone or something), typically in a formal statement
centripetal: moving or tending to move toward a center
cerebral: intellectual rather than emotional or physical
chagrin: distress or embarrassment at having failed or been humiliated
charlatan: a person falsely claiming to have a special knowledge or skill; a fraud
chicanery: the use of trickery to achieve a political, financial, or legal purpose
chide: to scold or rebuke
chimerical: existing only as the product of unchecked imagination; fantastically improbable
choleric: bad-tempered or irritable
churlish: rude in a mean-spirited and surly way
circumlocution: the use of many words where fewer would do, especially in a deliberate attempt to be vague or evasive
circumscribe: to restrict (something) within limits
circumvent: to find a way around (an obstacle)
clairvoyant: having or exhibiting an ability to perceive events in the future or beyond normal sensory contact
clamor: a loud and confused noise, especially that of people shouting vehemently
clandestine: kept secret or done secretively, especially because illicit
cleave: to split or sever (something), especially along a natural line or grain
clemency: mercy; lenience
cloying: disgust or sicken (someone) with an excess of sweetness, richness, or sentiment
coalesce: to come together and form one mass or whole
cogent: (of an argument or case) clear, logical, and convincing
cognizant: having knowledge or being aware of
collusion: secret or illegal cooperation or conspiracy, especially in order to cheat or deceive others
colloquial: (of language) used in ordinary or familiar conversation; not formal or literary
colossal: extremely large
comely: typically of a woman) pleasant to look at; attractive
commensurate: corresponding in size or degree; in proportion
commodious: (especially of furniture or a building) roomy and comfortable
compendium: a collection of concise but detailed information about a particular subject, especially in a book or other publication
complacency: a feeling of smug or uncritical satisfaction with oneself or one's achievements
compliant: inclined to agree with others or obey rules, especially to an excessive degree; acquiescent
compunction: a feeling of guilt or moral scruple that follows the doing of something bad
conciliatory: intended or likely to placate or pacify
condescend: to show feelings of superiority; be patronizing
condone: to accept and allow (behavior that is considered morally wrong or offensive) to continue
confound: to cause surprise or confusion in (someone), especially by acting against their expectations
congeal: to solidify or coagulate, especially by cooling
congenial: (of a person) pleasant because of a personality, qualities, or interests that are similar to one's own
congruity: the quality of being in agreement or harmony; compatibility
connoisseur: an expert judge in matters of taste
consensus: general agreement
consonant: in agreement or harmony with
conspicuous: standing out so as to be clearly visible
consummate: showing a high degree of skill and flair; complete or perfect
contend: to assert something as a position in an argument
contentious: causing or likely to cause an argument; controversial
contiguous: sharing a common border; touching
contrite: feeling or expressing remorse or penitence; affected by guilt
contumacious: (especially of a defendant's behavior) stubbornly or willfully disobedient to authority
conundrum: a confusing and difficult problem or question
convivial: (of an atmosphere or event) friendly, lively, and enjoyable
copious: abundant in supply or quantity
corpulent: (of a person) fat
corroborate: to confirm or give support to (a statement, theory, or finding)
cosmopolitan: familiar with and at ease in many different countries and cultures
coterie: a small group of people with shared interests or tastes, especially one that is exclusive of other people
countenance: a person's face or facial expression
craven: contemptibly lacking in courage; cowardly
credence: belief in or acceptance of something as true
credulous: having or showing too great a readiness to believe things
culpable: deserving blame
cursory: hasty and therefore not thorough or detailed
curtail: to reduce in extent or quantity; impose a restriction on
cynical: believing that people are motivated purely by self-interest; distrustful of human sincerity or integrity
dank: disagreeably damp, musty, and typically cold
daunt: to make (someone) feel intimidated or apprehensive
dearth: a scarcity or lack of something
debacle: a sudden and ignominious failure; a fiasco
debase: to reduce (something) in quality or value; degrade
debilitate: to make (someone) weak and infirm
debonair: (of a man) confident, stylish, and charming
decimate: to kill, destroy, or remove a large proportion of
decorum: behavior in keeping with good taste and propriety
decry: to publicly denounce
deference: humble submission and respect
defile: to sully, mar, or spoil
deft: neatly skillful and quick in one's movements
defunct: no longer existing or functioning
deign: to do something that one considers to be beneath one's dignity
deleterious: causing harm or damage
deliberate: done consciously and intentionally
delineate: to describe or portray (something) precisely
deluge: a severe flood
demagogue: a political leader who seeks support by appealing to the desires and prejudices of ordinary people rather than by using rational argument
demean: to cause a severe loss in the dignity of and respect for (someone or something)
demur: to raise doubts or objections or show reluctance
denigrate: to criticize unfairly; disparage
denizen: an inhabitant or occupant of a particular place
denouement: the final part of a play, movie, or narrative in which the strands of the plot are drawn together and matters are explained or resolved
deplore: to feel or express strong disapproval of (something)
depravity: moral corruption; wickedness
deprecate: to express disapproval of
deride: to express contempt for; ridicule
derivative: (typically of an artist or work of art) imitative of the work of another person, and usually disapproved of for that reason
derogatory: showing a critical or disrespectful attitude
desiccate: to remove the moisture from (something, especially food), typically in order to preserve it
despondent: in low spirits from loss of hope or courage
despot: a ruler or other person who holds absolute power, typically one who exercises it in a cruel or oppressive way
desultory: lacking a plan, purpose, or enthusiasm
deter: to discourage (someone) from doing something by instilling doubt or fear of the consequences
detraction: the action of taking away from the value or quality of something
detrimental: tending to cause harm
deviate: to depart from an established course
devoid: entirely lacking or free from
devout: having or showing deep religious feeling or commitment
dexterous: showing or having skill, especially with the hands
diatribe: a forceful and bitter verbal attack against someone or something
didactic: intended to teach, particularly in having moral instruction as an ulterior motive
diffidence: modesty or shyness resulting from a lack of self-confidence
diffuse: spread out over a large area; not concentrated
digress: to leave the main subject temporarily in speech or writing
dirge: a lament for the dead, especially one forming part of a funeral rite
disabuse: to persuade (someone) that an idea or belief is mistaken
disaffected: dissatisfied with the people in authority and no longer willing to support them
disavow: to deny any responsibility or support for
discern: to perceive or recognize (something)
discomfit: to make (someone) feel uneasy or embarrassed
disconcert: to disturb the composure of; unsettle
discordant: disagreeing or incongruous
discountenance: to refuse to approve of (something)
discourse: written or spoken communication or debate
discredit: harm the good reputation of (someone or something)
discreet: careful and circumspect in one's speech or actions, especially in order to avoid causing offense or to gain an advantage
discursive: digressing from subject to subject
disdain: the feeling that someone or something is unworthy of one's consideration or respect; contempt
disgorge: to cause to pour out
disgruntled: angry or dissatisfied
dishearten: to cause (someone) to lose determination or confidence
disheveled: (of a person's hair, clothes, or appearance) untidy; disordered
disinclination: a reluctance or lack of enthusiasm
disingenuous: not candid or sincere, typically by pretending that one knows less about something than one really does
disinter: to dig up (something that has been buried, especially a corpse)
disinterested: not influenced by considerations of personal advantage
disjointed: lacking a coherent sequence or connection
dislodge: to remove forcibly from a position
dismay: consternation and distress, typically that caused by something unexpected
disparage: to regard or represent as being of little worth
disparate: essentially different in kind; not allowing comparison
dispassionate: not influenced by strong emotion, and so able to be rational and impartial
dispatch: to send off to a destination or for a purpose
dispel: to make (a doubt, feeling, or belief) disappear
disperse: to distribute or spread over a wide area
dispirit: to cause (someone) to lose enthusiasm or hope
disseminate: to spread or disperse (something, especially information) widely
dissipate: to disperse or scatter
dissolution: the closing down or dismissal of an assembly, partnership, or official body
distend: to cause (something) to swell by stretching it from inside
distraught: very worried and upset
divergent: tending to be different or develop in different directions
divulge: to make known (private or sensitive information)
docile: ready to accept control or instruction; submissive
doctrinaire: seeking to impose a doctrine in all circumstances without regard to practical considerations
dogmatic: inclined to lay down principles as incontrovertibly true
doleful: expressing sorrow; mournful
dormant: having normal physical functions suspended or slowed down for a period of time; in or as if in a deep sleep
dross: something regarded as worthless; rubbish
duress: threats, violence, constraints, or other action brought to bear on someone to do something against their will or better judgment
duplicity: deceitfulness; double-dealing
ebullient: cheerful and full of energy
eccentric: unconventional and slightly strange
eclectic: deriving ideas, style, or taste from a broad and diverse range of sources
edict: an official order or proclamation issued by a person in authority
edify: to instruct or improve (someone) morally or intellectually
efface: to erase (a mark) from a surface
efficacious: (typically of something inanimate or abstract) successful in producing a desired or intended result; effective
effrontery: insolent or impertinent behavior
egregious: outstandingly bad; shocking
elicit: to evoke or draw out (a reaction, answer, or fact) from someone in reaction to one's own actions or questions
eloquent: fluent or persuasive in speaking or writing
elucidate: to make (something) clear; explain
elusive: difficult to find, catch, or achieve
emaciated: abnormally thin or weak, especially because of illness or a lack of food
emancipate: to set free, especially from legal, social, or political restrictions
embellish: to make (something) more attractive by the addition of decorative details or features
embezzle: to steal or misappropriate (money placed in one's trust or belonging to the organization for which one works)
emend: to make corrections and revisions to (a text)
eminent: famous and respected within a particular sphere or profession
empathy: the ability to understand and share the feelings of another
empirical: based on, concerned with, or verifiable by observation or experience rather than theory or pure logic
emulate: to match or surpass (a person or achievement), typically by imitation
enclave: a portion of territory within or surrounded by a larger territory whose inhabitants are culturally or ethnically distinct
encomium: a speech or piece of writing that praises someone or something highly
encroach: to intrude on (a person's territory, rights, personal life, etc.)
encumber: to restrict or impede (someone or something) in such a way that free action or movement is difficult
endemic: (of a disease or condition) regularly found among particular people or in a certain area
enervate: to cause (someone) to feel drained of energy or vitality; weaken
engender: to cause or give rise to (a feeling, situation, or condition)
enigma: a person or thing that is mysterious, puzzling, or difficult to understand
enmity: the state or feeling of being actively opposed or hostile to someone or something
ennui: a feeling of listlessness and dissatisfaction arising from a lack of occupation or excitement
ensconce: to establish or settle (someone) in a comfortable, safe, or secret place
entreat: to ask someone earnestly or anxiously to do something
enumerate: to mention (a number of things) one by one
ephemeral: lasting for a very short time
epicurean: a person devoted to refined sensuous enjoyment (especially good food and drink)
epiphany: a moment of sudden revelation or insight
epitome: a person or thing that is a perfect example of a particular quality or type
equanimity: mental calmness, composure, and evenness of temper, especially in a difficult situation
equitable: fair and impartial
equivocal: open to more than one interpretation; ambiguous
erudite: having or showing great knowledge or learning
esoteric: intended for or likely to be understood by only a small number of people with a specialized knowledge or interest
espouse: to adopt or support (a cause, belief, or way of life)
ethereal: extremely delicate and light in a way that seems too perfect for this world
euphemism: a mild or indirect word or expression substituted for one considered to be too harsh or blunt when referring to something unpleasant or embarrassing
euphoria: a feeling or state of intense excitement and happiness
evanescent: soon passing out of sight, memory, or existence; quickly fading or disappearing
evince: to reveal the presence of (a quality or feeling)
exacerbate: to make (a problem, bad situation, or negative feeling) worse
exalt: to hold (someone or something) in very high regard; think or speak very highly of
exasperate: to irritate and frustrate (someone) intensely
exemplar: a person or thing serving as a typical example or excellent model
exhort: to strongly encourage or urge (someone) to do something
exigent: pressing; demanding
existential: relating to existence
exonerate: to absolve (someone) from blame for a fault or wrongdoing, especially after due consideration of the case
exorbitant: (of a price or amount charged) unreasonably high
expatiate: to speak or write at length or in detail
expedient: (of an action) convenient and practical, although possibly improper or immoral
expiate: to atone for (guilt or sin)
explicate: to analyze and develop (an idea or principle) in detail
expository: intended to explain or describe something
extant: (especially of a document) still in existence; surviving
extol: to praise enthusiastically
extraneous: irrelevant or unrelated to the subject being dealt with
extrapolate: to extend the application of (a method or conclusion) to an unknown situation by assuming that existing trends will continue or similar methods will be applicable
extricate: to free (someone or something) from a constraint or difficulty
exult: to show or feel elation or jubilation, especially as the result of a success
facetious: treating serious issues with deliberately inappropriate humor; flippant
facile: (especially of a theory or argument) appearing neat and comprehensive only by ignoring the true complexities of an issue; superficial
factitious: artificially created or developed
factotum: an employee who does all kinds of work
fallacious: based on a mistaken belief
fallow: (of farmland) plowed and harrowed but left unsown for a period in order to restore its fertility or to avoid surplus production
fathom: to understand (a difficult problem or an enigmatic person) after much thought
fatuous: silly and pointless
fecund: producing or capable of producing an abundance of offspring or new growth; fertile
feign: to pretend to be affected by (a feeling, state, or injury)
felicitous: well chosen or suited to the circumstances
ferret: to search tenaciously for and find something
fervent: having or displaying a passionate intensity
fetid: smelling extremely unpleasant
fetter: a chain or manacle used to restrain a prisoner, typically placed around the ankles
fidelity: faithfulness to a person, cause, or belief, demonstrated by continuing loyalty and support
figurative: departing from a literal use of words; metaphorical
finagle: to obtain (something) by devious or dishonest means
finesse: intricate and refined delicacy
flagrant: (of something considered wrong or immoral) conspicuously or obviously offensive
flippant: not showing a serious or respectful attitude
florid: having a red or flushed complexion
flout: to openly disregard (a rule, law, or convention)
flummox: to bewilder or confuse (someone)
foible: a minor weakness or eccentricity in someone's character
foment: to instigate or stir up (an undesirable or violent sentiment or course of action)
forbearance: patient self-control; restraint and tolerance
forestall: to prevent or obstruct (an anticipated event or action) by taking action ahead of time
fortuitous: happening by accident or chance rather than design
fracas: a noisy disturbance or quarrel
fractious: (typically of children) irritable and quarrelsome
fruition: the point at which a plan or project is realized
frustrate: to prevent (a plan or attempted action) from progressing, succeeding, or being fulfilled
furtive: attempting to avoid notice or attention, typically because of guilt or a belief that discovery would lead to trouble; secretive
gainsay: to deny or contradict (a fact or statement)
gall: bold, impudent behavior
galvanize: to shock or excite (someone), typically into taking action
gambit: an act or remark that is calculated to gain an advantage, especially at the outset of a situation
garish: obtrusively bright and showy; lurid
garner: to gather or collect (something, especially information or approval)
garrulous: excessively talkative, especially on trivial matters
gauche: lacking ease or grace; unsophisticated and socially awkward
genial: friendly and cheerful
germane: relevant to a subject under consideration
glib: (of words or the person speaking them) fluent and voluble but insincere and shallow
goad: to provoke or annoy (someone) so as to stimulate some action or reaction
gossamer: used to refer to something very light, thin, and insubstantial or delicate
gourmand: a person who enjoys eating and often eats too much
grandiloquent: pompous or extravagant in language, style, or manner, especially in a way that is intended to impress
gratuitous: uncalled for; lacking good reason; unwarranted
gregarious: (of a person) fond of company; sociable
grievous: (of something bad) very severe or serious
grovel: to lie or crawl abjectly on the ground with one's face downwards
guile: sly or cunning intelligence
gullible: easily persuaded to believe something; credulous
gustatory: concerned with tasting or the sense of taste
hallowed: (of a building or room) holy or sacred
harangue: a lengthy and aggressive speech
harbinger: a person or thing that announces or signals the approach of another
haughty: arrogantly superior and disdainful
hegemony: leadership or dominance, especially by one country or social group over others
heinous: (of a person or wrongful act, especially a crime) utterly odious or wicked
heresy: belief or opinion contrary to orthodox religious doctrine
hermetic: (of a seal or closure) complete and airtight
heterogeneous: diverse in character or content
hirsute: hairy
hoary: grayish white
homage: special honor or respect shown publicly
homogeneous: of the same kind; alike
hubris: excessive pride or self-confidence
humdrum: lacking excitement or variety; dull; monotonous
hyperbole: exaggerated statements or claims not meant to be taken literally
iconoclast: a person who attacks cherished beliefs, traditional institutions, etc., as being based on superstition or dogma
ideology: a system of ideas and ideals, especially one that forms the basis of economic or political theory and policy
idiosyncrasy: a mode of behavior or way of thought peculiar to an individual
idolatry: extreme admiration, love, or reverence for something or someone
ignominy: public shame or disgrace
illicit: forbidden by law, rules, or custom
imbibe: to absorb or assimilate (ideas or knowledge)
imbroglio: an extremely confused, complicated, or embarrassing situation
immaculate: (especially of a person or their clothes) perfectly clean, neat, or tidy
imminent: about to happen
immutable: unchanging over time or unable to be changed
impair: to weaken or damage something, especially (of a human faculty or function) to be impaired
impassive: not feeling or showing emotion
impecunious: having little or no money
impede: to delay or prevent (someone or something) by obstructing them; hinder
impending: (of an event regarded as threatening or significant) about to happen; forthcoming
imperative: of vital importance; crucial
imperious: assuming power or authority without justification; arrogant and domineering
imperturbable: unable to be upset or excited; calm
impervious: not allowing fluid to pass through
impetuous: acting or done quickly and without thought or care
impinge: to have an effect, especially a negative one
implacable: unable to be placated
implicit: implied though not plainly expressed
implore: to beg earnestly for
importune: to harass (someone) persistently for or to do something
imprecation: a spoken curse
impromptu: done without being planned, organized, or rehearsed
impudent: not showing due respect for another person; impertinent
impugn: to dispute the truth, validity, or honesty of (a statement or motive); call into question
impute: to represent (something, especially something undesirable) as being done, caused, or possessed by someone; attribute
inadvertent: not resulting from or achieved through deliberate planning
inane: silly; stupid
inarticulate: unable to speak distinctly or express oneself clearly
incantation: a series of words said as a magic spell or charm
incendiary: tending to stir up conflict
incense: to make (someone) very angry
inchoate: just begun and so not fully formed or developed; rudimentary
incessant: (of something regarded as unpleasant) continuing without pause or interruption
incisive: (of a person or mental process) intelligently analytical and clear-thinking
inclement: (of the weather) unpleasantly cold or wet
incoherent: (of spoken or written language) expressed in an incomprehensible or confusing way; unclear
incognito: (of a person) having one's true identity concealed
incontrovertible: not able to be denied or disputed
incorrigible: (of a person or their tendencies) not able to be corrected, improved, or reformed
incredulous: (of a person or their manner) unwilling or unable to believe something
incumbent: (of an official or regime) currently holding office
incursion: an invasion or attack, especially a sudden or brief one
indelible: (of ink or a pen) making marks that cannot be removed
indict: to formally accuse of or charge with a serious crime
indigenous: originating or occurring naturally in a particular place; native
indignant: feeling or showing anger or annoyance at what is perceived as unfair treatment
indolent: wanting to avoid activity or exertion; lazy
indomitable: impossible to subdue or defeat
indubitable: impossible to doubt; unquestionable
induce: to succeed in persuading or influencing (someone) to do something
ineffable: too great or extreme to be expressed or described in words
ineluctable: unable to be resisted or avoided; inescapable
inept: having or showing no skill; clumsy
inert: lacking the ability or strength to move
inexorable: impossible to stop or prevent
infamy: the state of being well known for some bad quality or deed
infinitesimal: extremely small
infirmity: physical or mental weakness
influx: an arrival or entry of large numbers of people or things
infraction: a violation or infringement of a law, agreement, or set of rules
ingenious: clever, original, and inventive
ingenuous: innocent and unsuspecting
inhibit: to hinder, restrain, or prevent (an action or process)
inimical: tending to obstruct or harm
innate: inborn; natural
innocuous: not harmful or offensive
innuendo: an allusive or oblique remark or hint, typically a suggestive or disparaging one
inordinate: unusually or disproportionately large; excessive
inscrutable: impossible to understand or interpret
insidious: proceeding in a gradual, subtle way, but with harmful effects
insipid: lacking flavor
insolent: showing a rude and arrogant lack of respect
insouciant: showing a casual lack of concern; indifferent
insubordinate: defiant of authority; disobedient to orders
insular: ignorant of or uninterested in cultures, ideas, or peoples outside one's own experience
insurgent: rising in active revolt
interloper: a person who becomes involved in a place or situation where they are not wanted or are considered not to belong
interminable: endless (often used hyperbolically)
intrepid: fearless; adventurous (often used for rhetorical or humorous effect)
inundate: to overwhelm (someone) with things or people to be dealt with
inured: accustomed to something, especially something unpleasant
invective: insulting, abusive, or highly critical language
inveigh: to speak or write about (something) with great hostility
inveterate: having a particular habit, activity, or interest that is long-established and unlikely to change
invidious: (of an action or situation) likely to arouse resentment or anger in others
irascible: having or showing a tendency to be easily angered
itinerant: traveling from place to place
jabber: to talk rapidly and excitedly but with little sense
jargon: special words or expressions that are used by a particular profession or group and are difficult for others to understand
jaundiced: affected by bitterness, resentment, or envy
jocular: fond of or characterized by joking; humorous or playful
jubilant: feeling or expressing great happiness and triumph
juxtapose: to place or deal with close together for contrasting effect
ken: one's range of knowledge or sight
killjoy: a person who deliberately spoils the enjoyment of others through resentful or overly sober behavior
kindle: to light or set on fire
kismet: destiny; fate
kleptomaniac: a person who has an impulse or propensity to steal, although they are aware that they are doing wrong
knave: a dishonest or unscrupulous man
laconic: (of a person, speech, or style of writing) using very few words
laggard: a person who makes slow progress and falls behind others
lament: to mourn (a person's loss or death)
languid: displaying or having a disinclination for physical exertion or effort; slow and relaxed
languish: to lose or lack vitality; grow weak or feeble
larceny: theft of personal property
largesse: generosity in giving money or gifts
lascivious: (of a person, manner, or gesture) feeling or revealing an overt and often offensive sexual desire
lassitude: a state of physical or mental weariness; lack of energy
latent: (of a quality or state) existing but not yet developed or manifest; hidden; concealed
laud: to praise (a person or their achievements) highly, especially in a public context
lecherous: having or showing excessive or offensive sexual desire
lethargy: a lack of energy and enthusiasm
levity: humor or frivolity, especially the treatment of a serious matter with humor or in a manner lacking due respect
lexicon: the vocabulary of a person, language, or branch of knowledge
libation: a drink poured out as an offering to a deity
libertine: a person, especially a man, who behaves without moral principles or a sense of responsibility, especially in sexual matters
lien: a right to keep possession of property belonging to another person until a debt owed by that person is discharged
limpid: (of a liquid) free of anything that darkens; completely clear
lithe: (especially of a person's body) thin, supple, and graceful
litigious: prone to engage in lawsuits
livid: furiously angry
loath: reluctant; unwilling
loquacious: tending to talk a great deal; talkative
lucid: expressed clearly; easy to understand
ludicrous: so foolish, unreasonable, or out of place as to be amusing; ridiculous
lugubrious: looking or sounding sad and dismal
lurid: very vivid in color, especially so as to create an unpleasantly harsh or unnatural effect
machination: a plot or scheme
maelstrom: a powerful whirlpool in the sea or a river
magnanimous: very generous or forgiving, especially toward a rival or someone less powerful than oneself
magnate: a wealthy and influential businessman or businesswoman
magniloquent: using high-flown or bombastic language
malediction: a magical word or phrase uttered with the intention of bringing about evil or destruction; a curse
malevolent: having or showing a wish to do evil to others
malfeasance: wrongdoing, especially by a public official
malinger: to exaggerate or feign illness in order to escape duty or work
malleable: easily influenced; pliable
malign: to speak about (someone) in a spitefully critical manner
malinger: exaggerate or feign illness in order to escape duty or work
malleable: able to be hammered or pressed permanently out of shape without breaking or cracking
manacle: a metal band, chain, or shackle for fastening someone's hands or ankles
manifest: clear or obvious to the eye or mind
manifestation: an event, action, or object that clearly shows or embodies something, especially a theory or an abstract idea
manifold: many and various
manipulative: characterized by unscrupulous control of a situation or person
mannerism: a habitual gesture or way of speaking or behaving; an idiosyncrasy
marauder: a raider
marginalia: notes written in the margin of a book or manuscript
martial: of or appropriate to war; warlike
masticate: to chew (food)
matriarchy: a system of society or government ruled by a woman or women
maudlin: self-pityingly or tearfully sentimental, often through drunkenness
maverick: an unorthodox or independent-minded person
mawkish: sentimental in a feeble or sickly way
maxim: a short, pithy statement expressing a general truth or rule of conduct
mellifluous: (of a voice or words) sweet or musical; pleasant to hear
mendacious: not telling the truth; lying
mendicant: given to begging
mercenary: (of a person or their behavior) primarily concerned with making money at the expense of ethics
mercurial: subject to sudden or unpredictable changes of mood or mind
meticulous: showing great attention to detail; very careful and precise
mettle: a person's ability to cope well with difficulties; spirit and resilience
mettlesome: full of spirit and courage
miasma: a highly unpleasant or unhealthy smell or vapor
milieu: a person's social environment
militate: to be a powerful or conclusive factor in preventing
minatory: expressing or conveying a threat
minutiae: the small, precise, or trivial details of something
miscreant: a person who behaves badly or in a way that breaks the law
misdemeanor: a minor wrongdoing
misogyny: dislike of, contempt for, or ingrained prejudice against women
mnemonic: aiding or designed to aid the memory
modicum: a small quantity of a particular thing, especially something considered desirable or valuable
modulate: to exert a modifying or controlling influence on
mollify: to appease the anger or anxiety of (someone)
molt: (of a bird or other animal) shed old feathers, hair, or skin to make way for a new growth
moratorium: a temporary prohibition of an activity
mores: the essential or characteristic customs and conventions of a society or community
mote: a tiny piece of a substance
motley: incongruously varied in appearance or character; disparate
muddle: to bring into a disordered or confusing state
mulct: to extract money from (someone) by fine or taxation
multifarious: many and of various types
mundane: lacking interest or excitement; dull
munificent: (of a gift or sum of money) larger or more generous than is usual or necessary
myriad: a countless or extremely great number
nadir: the lowest point in the fortunes of a person or organization
nascent: (especially of a process or organization) just coming into existence and beginning to display signs of future potential
nebulous: in the form of a cloud or haze; hazy
necromancy: the supposed practice of communicating with the dead, especially in order to predict the future
negligible: so small or unimportant as to be not worth considering; insignificant
neophyte: a person who is new to a subject, skill, or belief
nepotism: the practice among those with power or influence of favoring relatives or friends, especially by giving them jobs
nescience: lack of knowledge or awareness; ignorance
niggardly: not generous; stingy
nihilism: the rejection of all religious and moral principles, often in the belief that life is meaningless
nirvana: a state of perfect happiness; an ideal or idyllic place
noisome: having an extremely offensive smell
nominal: (of a role or status) existing in name only
nonchalant: feeling or appearing casually calm and relaxed; not displaying anxiety, interest, or enthusiasm
nonentity: a person or thing with no special or interesting qualities; an unimportant person or thing
nonpareil: having no match or equal; unrivaled
noxious: harmful, poisonous, or very unpleasant
nuance: a subtle difference in or shade of meaning, expression, or sound
nullify: to make legally null and void; invalidate
numinous: having a strong religious or spiritual quality; indicating or suggesting the presence of a divinity
nurture: to care for and protect (someone or something) while they are growing
obdurate: stubbornly refusing to change one's opinion or course of action
obfuscate: to render obscure, unclear, or unintelligible
oblique: not explicit or done in a direct way
obliterate: to destroy utterly; wipe out
oblivion: the state of being unaware or unconscious of what is happening
obnoxious: extremely unpleasant
obsequious: obedient or attentive to an excessive or servile degree
obtuse: annoyingly insensitive or slow to understand
obviate: to remove (a need or difficulty)
occlude: to stop, close up, or obstruct (an opening, orifice, or passage)
odious: extremely unpleasant; repulsive
odium: general or widespread hatred or disgust directed toward someone as a result of their actions
odoriferous: having or giving off a smell, especially an unpleasant or distinctive one
offal: the entrails and internal organs of an animal used as food
officious: assertive of authority in an annoyingly domineering way, especially with regard to petty or trivial matters
ominous: giving the impression that something bad or unpleasant is going to happen; threatening; inauspicious
omnipotent: (of a deity) having unlimited power; able to do anything
onerous: involving an amount of effort and difficulty that is oppressively burdensome
onomatopoeia: the formation of a word from a sound associated with what is named
ontological: relating to the branch of metaphysics dealing with the nature of being
onus: used to refer to something that is one's duty or responsibility
opine: to hold and state as one's opinion
opprobrium: harsh criticism or censure
ossify: to turn into bone or bony tissue
ostensible: stated or appearing to be true, but not necessarily so
ostentation: pretentious and vulgar display, especially of wealth and luxury, intended to impress or attract notice
ostracize: to exclude (someone) from a society or group
overt: done or shown openly; plainly or readily apparent, not secret or hidden
overweening: showing excessive confidence or pride
pachyderm: a very large mammal with thick skin, especially an elephant, rhinoceros, or hippopotamus
paean: a song of praise or triumph
palliate: to make (a disease or its symptoms) less severe or unpleasant without removing the cause
palpable: (of a feeling or atmosphere) so intense as to be almost touched or felt
paltry: (of an amount) small or meager
panacea: a solution or remedy for all difficulties or diseases
panache: flamboyant confidence of style or manner
pandemic: (of a disease) prevalent over a whole country or the world
panegyric: a public speech or published text in praise of someone or something
panoply: an extensive or impressive collection
paradigm: a typical example or pattern of something; a model
paradox: a statement or proposition that, despite sound (or apparently sound) reasoning from acceptable premises, leads to a conclusion that seems senseless, logically unacceptable, or self-contradictory
paragon: a person or thing regarded as a perfect example of a particular quality
parameter: a numerical or other measurable factor forming one of a set that defines a system or sets the conditions of its operation
paramour: a lover, especially the illicit partner of a married person
pariah: an outcast
parity: the state or condition of being equal, especially regarding status or pay
parochial: relating to a church parish
parry: to ward off (a weapon or attack) with a countermove
parsimonious: unwilling to spend money or use resources; stingy or frugal
partisan: a strong supporter of a party, cause, or person
patina: a green or brown film on the surface of bronze or similar metals, produced by oxidation over a long period
patois: the dialect of the common people of a region, differing in various respects from the standard language of the rest of the country
paucity: the presence of something only in small or insufficient quantities or amounts; scarcity
peccadillo: a small, relatively unimportant offense or sin
pecuniary: relating to or consisting of money
pedagogue: a teacher, especially a strict or pedantic one
pedantic: excessively concerned with minor details or rules; over scrupulous
peerless: unequaled; unrivaled
pejorative: expressing contempt or disapproval
pellucid: translucently clear; lucid in style or meaning; easily understood
penchant: a strong or habitual liking for something or tendency to do something
penitent: feeling or showing sorrow and regret for having done wrong; repentant
pensive: engaged in, involving, or reflecting deep or serious thought
perambulate: to walk or travel through or around a place or area, especially for pleasure and in a leisurely way
perdition: a state of eternal punishment and damnation into which a sinful and unpenitent person passes after death
peregrinate: to travel or wander around from place to place
peremptory: insisting on immediate attention or obedience, especially in a brusquely imperious way
perennial: lasting or existing for a long or apparently infinite time; enduring or continually recurring
perfidious: deceitful and untrustworthy
perfunctory: (of an action or gesture) carried out with a minimum of effort or reflection
perigee: the point in the orbit of the moon or a satellite at which it is nearest to the earth
periphery: the outer limits or edge of an area or object
perjury: the offense of willfully telling an untruth in a court after having taken an oath or affirmation
permeate: to spread throughout (something); pervade
pernicious: having a harmful effect, especially in a gradual or subtle way
perquisite: a thing regarded as a special right or privilege enjoyed as a result of one's position
perspicacious: having a ready insight into and understanding of things
pert: (of a girl or young woman) attractively lively or cheeky
pertinacious: holding firmly to an opinion or a course of action
perturb: to make (someone) anxious or unsettled
peruse: to read (something), typically in a thorough or careful way
pervade: to spread through and be perceived in every part of
petulant: (of a person or their manner) childishly sulky or bad-tempered
philanderer: a man who readily or frequently enters into casual sexual relationships with women; a womanizer
philistine: a person who is hostile or indifferent to culture and the arts, or who has no understanding of them
phlegmatic: (of a person) having an unemotional and stolidly calm disposition
phobia: an extreme or irrational fear of or aversion to something
phoenix: a unique bird in Egyptian mythology which periodically burned itself on a funeral pyre and rose from the ashes with renewed youth to live through another cycle
physiognomy: a person's facial features or expression, especially when regarded as indicative of character or ethnic origin
pious: devoutly religious
pique: to stimulate (interest or curiosity)
pith: the essence or main point of something
placate: to make (someone) less angry or hostile
platitude: a remark or statement, especially one with a moral content, that has been used too often to be interesting or thoughtful
plethora: an excess of something
pliable: easily bent; flexible
plumage: a bird's feathers collectively
plumb: to measure the depth of (a body of water)
plummet: to fall or drop straight down at high speed
plunder: to steal goods from (a place or person), typically using force and in a time of war or civil disorder
poignant: evoking a keen sense of sadness or regret
polemic: a strong verbal or written attack on someone or something
pontificate: to express one's opinions in a way considered annoyingly pompous and dogmatic
portent: a sign or warning that something, especially something momentous or calamitous, is likely to happen
portmanteau: a large suitcase
portray: to depict (someone or something) in a work of art or literature
poseur: a person who acts in an affected manner in order to impress others
potable: safe to drink; drinkable
potentate: a monarch or ruler, especially an autocratic one
potentiate: to enhance or increase the effectiveness, or potential of (a drug, action, or physiological response)
pragmatic: dealing with things sensibly and realistically in a way that is based on practical rather than theoretical considerations
prate: to talk foolishly or tediously about something
prattle: to talk at length in a foolish or inconsequential way
precarious: not securely held or in position; dangerously likely to fall or collapse
precipice: a very steep rock face or cliff, typically a tall one
precocious: (of a child) having developed certain abilities or proclivities at an earlier age than usual
predilection: a preference or special liking for something; a bias in favor of something
preen: to devote effort to making oneself look attractive and then admire one's appearance
preponderance: the quality or fact of being greater in number, quantity, or importance
presage: (of an event) be a sign or warning that (something, typically something bad) will happen
prestidigitation: magic tricks performed as entertainment
prevaricate: to speak or act in an evasive way
primordial: existing at or from the beginning of time; primeval
pristine: in its original condition; unspoiled
probity: the quality of having strong moral principles; honesty and decency
proclivity: a tendency to choose or do something regularly; an inclination or predisposition toward a particular thing
procrastinate: to delay or postpone action; put off doing something
prodigious: remarkably or impressively great in extent, size, or degree
profligate: recklessly extravagant or wasteful in the use of resources
profound: (of a state, quality, or emotion) very great or intense
profusion: an abundance or large quantity of something
progeny: a descendant or the descendants of a person, animal, or plant; offspring
prognosticate: to foretell or prophesy (an event in the future)
prolix: (of speech or writing) using or containing too many words; tediously lengthy
promulgate: to promote or make widely known (an idea or cause)
propagate: to spread and promote (an idea, theory, etc.) widely
propinquity: the state of being close to someone or something; proximity
propitiate: to win or regain the favor of (a god, spirit, or person) by doing something that pleases them
propitious: giving or indicating a good chance of success; favorable
prosaic: having or using the style or diction of prose as opposed to poetry; lacking imaginativeness or originality
proscribe: to forbid, especially by law
proselytize: to convert or attempt to convert (someone) from one religion, belief, or opinion to another
prosody: the patterns of rhythm and sound used in poetry
protean: able to change or adapt widely; able to do many different things
protégé: a person who is guided and supported by an older and more experienced or influential person
protract: to prolong; to lengthen in time
provident: making or indicative of timely preparation for the future
provisional: arranged or existing for the present, possibly to be changed later
proviso: a condition or qualification attached to an agreement or statement
prowess: skill or expertise in a particular activity or field
pugnacious: eager or quick to argue, quarrel, or fight
puissant: having great power or influence
punctilious: showing great attention to detail or correct behavior
pundit: an expert in a particular subject or field who is frequently called on to give opinions about it to the public
punitive: inflicting or intended as punishment
purloin: to steal (something)
purview: the scope of the influence or concerns of something
pusillanimous: showing a lack of courage or determination; timid
putative: generally considered or reputed to be
pyrrhic: (of a victory) won at too great a cost to have been worthwhile for the victor
quaff: to drink (something, especially an alcoholic drink) heartily
quagmire: a soft boggy area of land that gives way underfoot
quail: to feel or show fear or apprehension
quandary: a state of perplexity or uncertainty over what to do in a difficult situation
quash: to reject or void, especially by legal procedure
querulous: complaining in a rather petulant or whining manner
quibble: to argue or raise objections about a trivial matter
quintessential: representing the most perfect or typical example of a quality or class
quip: a witty remark
quixotic: exceedingly idealistic; unrealistic and impractical
quotidian: of or occurring every day; daily
raconteur: a person who tells anecdotes in a skillful and amusing way
rancor: bitterness or resentfulness, especially when long-standing
rapacious: aggressively greedy or grasping
rapt: completely fascinated by what one is seeing or hearing
rapture: a feeling of intense pleasure or joy
rash: displaying or proceeding from a lack of careful consideration of the possible consequences of an action
ratify: to sign or give formal consent to (a treaty, contract, or agreement), making it officially valid
ravenous: extremely hungry
raze: to completely destroy (a building, town, or other site)
recalcitrant: having an obstinately uncooperative attitude toward authority or discipline
recant: to say that one no longer holds an opinion or belief, especially one considered heretical
recapitulate: to summarize and state again the main points of
recidivism: the tendency of a convicted criminal to reoffend
recluse: a person who lives a solitary life and tends to avoid other people
recondite: (of a subject or knowledge) little known; abstruse
recumbent: (especially of a person or human figure) lying down
redolent: strongly reminiscent or suggestive of
redoubtable: (of a person) formidable, especially as an opponent
redundant: not or no longer needed or useful; superfluous
refractory: stubborn or unmanageable
refulgent: shining very brightly
refurbish: to renovate and redecorate (something, especially a building)
refute: to prove (a statement or theory) to be wrong or false; disprove
regale: to entertain or amuse (someone) with talk
regicide: the action of killing a king
relegate: to consign or dismiss to an inferior rank or position
relentless: oppressively constant; incessant
relic: an object surviving from an earlier time, especially one of historical or sentimental interest
remiss: lacking care or attention to duty; negligent
renege: to go back on a promise, undertaking, or contract
renounce: to formally declare one's abandonment of (a claim, right, or possession)
repast: a meal
repine: to feel or express discontent; fret
replete: filled or well-supplied with something
reprieve: to cancel or postpone the punishment of (someone, especially someone condemned to death)
reprobate: an unprincipled person (often used humorously or affectionately)
reprove: to reprimand or censure (someone)
repudiate: to refuse to accept or be associated with
repugnant: extremely distasteful; unacceptable
rescind: to revoke, cancel, or repeal (a law, order, or agreement)
resplendent: attractive and impressive through being richly colorful or sumptuous
restive: unable to keep still or silent and becoming increasingly difficult to control, especially because of impatience, dissatisfaction, or boredom
reticent: not revealing one's thoughts or feelings readily
retribution: punishment inflicted on someone as vengeance for a wrong or criminal act
retroactive: (especially of legislation) taking effect from a date in the past
retrograde: directed or moving backward
revel: to enjoy oneself in a lively and noisy way, especially with drinking and dancing
revere: to feel deep respect or admiration for (something)
reverie: a state of being pleasantly lost in one's thoughts; a daydream
rhetoric: the art of effective or persuasive speaking or writing, especially the use of figures of speech and other compositional techniques
ribald: referring to sexual matters in an amusingly rude or irreverent way
rife: (especially of something undesirable) of common occurrence; widespread
rift: a crack, split, or break in something
risqué: slightly indecent or liable to shock, especially by being sexually suggestive
rococo: characterized by an elaborately ornamental late baroque style of decoration prevalent in 18th-century Continental Europe, with asymmetrical patterns involving motifs and scrollwork
rotund: (of a person) large and plump
ruminate: to think deeply about something
saccharine: excessively sweet or sentimental
sacrosanct: regarded as too important or valuable to be interfered with
sagacious: having or showing keen mental discernment and good judgment; shrewd
salacious: having or conveying undue or inappropriate interest in sexual matters
salient: most noticeable or important
sallow: (of a person's face or complexion) of an unhealthy yellow or pale brown color
salubrious: health-giving; healthy
salutary: (especially with reference to something unwelcome or unpleasant) producing good effects; beneficial
sanctimonious: making a show of being morally superior to other people
sangfroid: composure or coolness, sometimes excessive, as shown in danger or under trying circumstances
sanguine: optimistic or positive, especially in an apparently bad or difficult situation
sapid: having a strong, pleasant taste
sardonic: grimly mocking or cynical
satiate: to satisfy (a desire or an appetite) to the full
satiety: the feeling or state of being satisfied, especially to excess
satire: the use of humor, irony, exaggeration, or ridicule to expose and criticize people's stupidity or vices, particularly in the context of contemporary politics and other topical issues
saturate: to cause (something) to become thoroughly soaked with liquid so that no more can be absorbed
savage: fierce, violent, and uncontrolled
savant: a learned person, especially a distinguished scientist
savor: to enjoy or appreciate (something pleasant) completely, especially by dwelling on it
scintillate: to emit flashes of light; sparkle
scoff: to speak to someone or about something in a scornfully derisive or mocking way
scourge: a person or thing that causes great trouble or suffering
scruple: a feeling of doubt or hesitation with regard to the morality or propriety of a course of action
scuttle: to run hurriedly or furtively with short quick steps
secular: denoting attitudes, activities, or other things that have no religious or spiritual basis
sedentary: (of a person) tending to spend much time seated; somewhat inactive
sedition: conduct or speech inciting people to rebel against the authority of a state or monarch
sedulous: (of a person or action) showing dedication and diligence
seethe: to be filled with intense but unexpressed anger
seismic: relating to earthquakes or other vibrations of the earth and its crust
semblance: the outward appearance or apparent form of something, especially when the reality is different
seminal: (of a work, event, moment, or figure) strongly influencing later developments
senescent: growing old; aging
sententious: given to moralizing in a pompous or affected manner
sentient: able to perceive or feel things
sentinel: a soldier or guard whose job is to stand and keep watch
sequester: to isolate or hide away (someone or something)
sere: (especially of vegetation) dry or withered
serendipity: the occurrence and development of events by chance in a happy or beneficial way
serene: calm, peaceful, and untroubled; tranquil
serpentine: of or like a serpent or snake
servile: having or showing an excessive willingness to serve or please others
severance: the action of ending a connection or relationship
shibboleth: a custom, principle, or belief distinguishing a particular class or group of people, especially a long-standing one regarded as outmoded or no longer important
shroud: a length of cloth or an enveloping garment in which a dead person is wrapped for burial
shun: to persistently avoid, ignore, or reject (someone or something) through antipathy or caution
sidereal: of or with respect to the distant stars (i.e., the constellations or fixed stars, not the sun or planets)
sinecure: a position requiring little or no work but giving the holder status or financial benefit
sinuous: having many curves and turns
skeptic: a person inclined to question or doubt accepted opinions
skulduggery: underhanded or unscrupulous behavior; trickery
slake: to quench or satisfy (one's thirst)
slew: a large number or quantity of something
slothful: lazy
slough: a swamp
sluggard: a lazy, sluggish person
smattering: a small amount of something
snide: derogatory or mocking in an indirect way
snippet: a small piece or brief extract
sobriquet: a person's nickname
sodden: saturated with liquid, especially water; soaked through
solace: comfort or consolation in a time of distress or sadness
solecism: a grammatical mistake in speech or writing
solicitous: characterized by or showing interest or concern
solipsism: the view or theory that the self is all that can be known to exist
somnolent: sleepy; drowsy
sonorous: (of a person's voice or other sound) imposingly deep and full
soporific: tending to induce drowsiness or sleep
sordid: involving ignoble actions and motives; arousing moral distaste and contempt
sought: past and past participle of seek
spectrum: used to classify something in terms of its position on a scale between two extreme points
speculate: to form a theory or conjecture about a subject without firm evidence
spleen: a large, vascular organ in the abdominal cavity
sporadic: occurring at irregular intervals or only in a few places; scattered or isolated
spurious: not being what it purports to be; false or fake
spurn: to reject with disdain or contempt
squalid: (of a place) extremely dirty and unpleasant, especially as a result of poverty or neglect
squelch: to make a soft sucking sound such as that made by walking heavily through mud
stalwart: loyal, reliable, and hardworking
stanch: to stop or restrict (a flow of blood) from a wound
stasis: a period or state of inactivity or equilibrium
staunch: loyal and committed in attitude
steadfast: resolutely or dutifully firm and unwavering
stevedore: a person employed, or a contractor engaged, at a dock to load and unload cargo from ships
stigmatize: to describe or regard as worthy of disgrace or great disapproval
stipulate: to demand or specify (a requirement), typically as part of a bargain or agreement
stodgy: heavy, filling, and high in carbohydrates
stoke: to stir up or tend (a fire) by adding fuel
stolid: (of a person) calm, dependable, and showing little emotion or animation
stratagem: a plan or scheme, especially one used to outwit an opponent or achieve an end
strident: loud and harsh; grating
stringent: (of regulations, requirements, or conditions) strict, precise, and exacting
strut: a rod or bar forming part of a framework and designed to resist compression
stultify: to cause to lose enthusiasm and initiative, especially as a result of a tedious or restrictive routine
stupefy: to make (someone) unable to think or feel properly
stymie: to prevent or hinder the progress of
subjugate: to bring under domination or control, especially by conquest
sublime: of such excellence, grandeur, or beauty as to inspire great admiration or awe
subliminal: (of a stimulus or mental process) below the threshold of sensation or consciousness; perceived by or affecting someone's mind without their being aware of it
suborn: to bribe or otherwise induce (someone) to commit an unlawful act such as perjury
subpoena: a writ ordering a person to attend a court
subterfuge: deceit used in order to achieve one's goal
subversive: seeking or intended to subvert an established system or institution
succinct: (especially of something written or spoken) briefly and clearly expressed
succor: assistance and support in times of hardship and distress
suffuse: to gradually spread through or over
sully: to damage the purity or integrity of; defile
sumptuous: splendid and expensive-looking
sunder: to split apart (especially in a violent way)
supercilious: behaving or looking as though one thinks one is superior to others
superfluous: unnecessary, especially through being more than enough
supine: lying face upward
supplant: to supersede and replace
surfeit: an excessive amount of something
surreptitious: kept secret, especially because it would not be approved of
surrogate: a substitute, especially a person deputizing for another in a specific role or office
sycophant: a person who acts obsequiously toward someone important in order to gain advantage
synthesis: the combination of ideas to form a theory or system
tacit: understood or implied without being stated
taciturn: (of a person) reserved or uncommunicative in speech; saying little
tactile: of or connected with the sense of touch
talisman: an object, typically an inscribed ring or stone, that is thought to have magic powers and to bring good luck
tangential: relating to or along a tangent
tangible: perceptible by touch
tantalize: to torment or tease (someone) with the sight or promise of something that is unobtainable
tantamount: equivalent in seriousness to; virtually the same as
tarry: to stay longer than intended; delay leaving a place
taut: stretched or pulled tight; not slack
tawdry: showy but cheap and of poor quality
teetotal: practicing complete abstinence from alcoholic drinks
temerity: excessive confidence or boldness; audacity
temperance: moderation or self-restraint, especially in eating and drinking
temporal: relating to worldly as opposed to spiritual affairs; secular
tenacious: tending to keep a firm hold of something; clinging or adhering closely
tenuous: very weak or slight
terse: sparing in the use of words; abrupt
thespian: relating to drama and the theater
thrall: the state of being in someone's power or having great power over someone
thwart: to prevent (someone) from accomplishing something
timorous: showing or suffering from nervousness, fear, or a lack of confidence
tirade: a long, angry speech of criticism or accusation
toady: a person who behaves obsequiously to someone important
tome: a book, especially a large, heavy, scholarly one
torpid: mentally or physically inactive; lethargic
torrid: very hot and dry
tortuous: full of twists and turns
touted: attempt to sell (something), typically by pestering people in an aggressive or bold manner
tractable: easy to control or influence
transcendent: beyond or above the range of normal or physical human experience
transient: lasting only for a short time; impermanent
transmute: to change in form, nature, or substance
trepidation: a feeling of fear or agitation about something that may happen
trenchant: vigorous or incisive in expression or style
trepidation: a feeling of fear or agitation about something that may happen
trite: (of a remark, opinion, or idea) overused and consequently of little import; lacking originality or freshness
truculent: eager or quick to argue or fight; aggressively defiant
truism: a statement that is obviously true and says nothing new or interesting
tumult: a loud, confused noise, especially one caused by a large mass of people
turbid: (of a liquid) cloudy, opaque, or thick with suspended matter
turgid: swollen and distended or congested
turpitude: depravity; wickedness
tyro: a beginner or novice
ubiquitous: present, appearing, or found everywhere
ulterior: existing beyond what is obvious or admitted; intentionally hidden
umbrage: offense or annoyance
unassailable: unable to be attacked, questioned, or defeated
unbidden: without having been commanded or invited
unconscionable: not right or reasonable
unctuous: excessively flattering or ingratiating; oily
undermine: to damage or weaken (someone or something), especially gradually or insidiously
underscore: to emphasize (something)
underwrite: to sign and accept liability under (an insurance policy), thus guaranteeing payment in case loss or damage occurs
undulate: to move with a smooth wavelike motion
unencumbered: not having any burden or impediment
unequivocal: leaving no doubt; unambiguous
unfettered: release from restraint or inhibition
ungainly: (of a person or movement) awkward; clumsy
unimpeachable: not able to be doubted, questioned, or criticized; entirely trustworthy
unmitigated: absolute; unqualified
unobtrusive: not conspicuous or attracting attention
unpalatable: not pleasant to taste
unprecedented: never done or known before
unremitting: never relaxing or slackening; incessant
unscathed: without suffering any injury, damage, or harm
unseemly: (of behavior or actions) not proper or appropriate
untenable: (especially of a position or view) not able to be maintained or defended against attack or objection
untoward: unexpected and inappropriate or inconvenient
untrammeled: not deprived of freedom of action or expression; not restricted or hampered
untoward: unexpected and inappropriate or inconvenient
unwieldy: difficult to carry or move because of its size, shape, or weight
unwonted: unaccustomed or unusual
upbraid: to scold or criticize (someone) angrily
urbane: (of a person, especially a man) suave, courteous, and refined in manner
usurp: to take (a position of power or importance) illegally or by force
utilitarian: designed to be useful or practical rather than attractive
utopia: an imagined place or state of things in which everything is perfect
uxorious: having or showing an excessive or submissive fondness for one's wife
vacillate: to waver between different opinions or actions; be indecisive
vacuous: having or showing a lack of thought or intelligence; mindless
vagary: an unexpected and inexplicable change in a situation or in someone's behavior
vagabond: a person who wanders from place to place without a home or job
vagrant: a person without a settled home or regular work who wanders from place to place and lives by begging
vapid: offering nothing that is stimulating or challenging
variegated: exhibiting different colors, especially as irregular patches or streaks
venerate: to regard with great respect; revere
venial: denoting a sin that is not regarded as depriving the soul of divine grace
venturesome: willing to take risks or embark on difficult or unusual courses of action
veracity: conformity to facts; accuracy
verdant: (of countryside) green with grass or other rich vegetation
veritable: used for emphasis, often to qualify a metaphor
vernacular: the language or dialect spoken by the ordinary people in a particular country or region
vernal: of, in, or appropriate to spring
versatile: able to adapt or be adapted to many different functions or activities
vertigo: a sensation of whirling and loss of balance, associated particularly with looking down from a great height
verve: vigor and spirit or enthusiasm
vestige: a trace of something that is disappearing or no longer exists
vex: to make (someone) feel annoyed, frustrated, or worried, especially with trivial matters
vicarious: experienced in the imagination through the feelings or actions of another person
victuals: food or provisions, typically as prepared for consumption
vigilant: keeping careful watch for possible danger or difficulties
vilify: to speak or write about in an abusively disparaging manner
vim: energy; enthusiasm
vindictive: having or showing a strong or unreasoning desire for revenge
virago: a domineering, violent, or bad-tempered woman
virtuoso: a person highly skilled in music or another artistic pursuit
virulent: (of a disease or poison) extremely severe or harmful in its effects
visage: a person's face, with reference to the form or proportions of the features
visceral: relating to deep inward feelings rather than to the intellect
viscosity: the state of being thick, sticky, and semifluid in consistency, due to internal friction
vise: a metal tool with movable jaws that are used to hold an object firmly in place while work is done on it, typically attached to a workbench
vivacious: (especially of a woman) attractively lively and animated
vivify: to enliven or animate
vociferous: (especially of a person or speech) vehement or clamorous
vogue: a fashion or general liking, especially one that is temporary
volition: the faculty or power of using one's will
voluble: speaking or spoken incessantly and fluently
voracious: wanting or devouring great quantities of food
votary: a devoted follower, adherent, or advocate of someone or something
waffle: to talk or write a lot without giving any useful information or any clear answers
waft: to pass or cause to pass easily or gently through or as if through the air
wallow: to indulge in an unrestrained way in (something that creates a pleasurable sensation)
wan: (of a person's complexion or appearance) pale and giving the impression of illness or exhaustion
wane: to decrease in vigor, power, or extent; become weaker
wanton: (of a cruel or violent action) deliberate and unprovoked
welter: to move in a turbulent fashion
whelp: a puppy
whet: to sharpen the blade of (a tool or weapon)
whimsical: playfully quaint or fanciful, especially in an appealing and amusing way
wince: to give a slight involuntary grimace or shrinking movement of the body out of or in anticipation of pain or distress
wistful: having or showing a feeling of vague or regretful longing
wizened: shriveled or wrinkled with age
wraith: a ghost or ghostlike image of someone, especially one seen shortly before or after their death
wrangle: to have a long, complicated dispute or argument
writhe: to make continual twisting, squirming movements or contortions of the body
wroth: (chiefly in biblical use) angry
wrought: (of metals) beaten out or shaped by hammering
wry: using or expressing dry, especially mocking, humor
xenophobe: a person having a dislike of or prejudice against people from other countries
xerophyte: a plant that lives in conditions of aridity
yeoman: a servant in a royal or noble household, ranking between a sergeant and a groom or a squire and a page
yoke: to combine or connect; link
yore: of long ago or former times (used in nostalgic or mock-nostalgic recollection)
yurt: a circular tent of felt or skins on a collapsible framework, used by nomads in Mongolia, Siberia, and Turkey
zeitgeist: the defining spirit or mood of a particular period of history as shown by the ideas and beliefs of the time
zenith: the highest point reached by a celestial or other object
zephyr: a soft, gentle breeze
zenith: the highest point reached by a celestial or other object
zephyr: a soft, gentle breeze